1111113311
1        1
1  1113  1
3  1     1
1  1111  3
1  3     3
1  1111  1
3        1
1        1
1111333111